1x11111
1000101
1100001
1100011
1000101
1111y11




